10 8 8
...a..^^
A^^^^jJ^
^^^^.^^i
.^^GHghI
^Ff^?^^^
BeE.###.
..b..^^?
##cDd@.#
