4 10 10
....a..^#^
.#^^^^^^^^
.^^^^.^^^#
....^###^.
^^^^A?##^^
#B..#####.
#..b..^^^.
######c...
^..C....dD
#..^^^^@^.